#############
#           #
#   T       #
#           #
#     S     #
#           #
#       E   #
#############